[console_scripts]
fermipy-assemble-model = fermipy.diffuse.gt_assemble_model:main_single
fermipy-assemble-model-sg = fermipy.diffuse.gt_assemble_model:main_batch
fermipy-astroserver = fermipy.scripts.astroserver:main
fermipy-catalog-chain = fermipy.diffuse.catalog_src_manager:main_chain
fermipy-clone-configs = fermipy.scripts.clone_configs:main
fermipy-cluster-sources = fermipy.scripts.cluster_sources:main
fermipy-coadd = fermipy.scripts.coadd:main
fermipy-coadd-split = fermipy.diffuse.gt_coadd_split:main
fermipy-collect-sources = fermipy.scripts.collect_sources:main
fermipy-diffuse-analysis = fermipy.diffuse.diffuse_analysis:main_chain
fermipy-diffuse-chain = fermipy.diffuse.diffuse_src_manager:main_chain
fermipy-dispatch = fermipy.scripts.dispatch:main
fermipy-file-archive = fermipy.jobs.file_archive:main_browse
fermipy-flux-sensitivity = fermipy.scripts.flux_sensitivity:main
fermipy-gtexcube2-sg = fermipy.diffuse.job_library:invoke_sg_gtexpcube2
fermipy-gtexphpsun-sg = fermipy.diffuse.solar:invoke_sg_Gtexphpsun
fermipy-gtsuntemp-sg = fermipy.diffuse.solar:invoke_sg_Gtsuntemp
fermipy-healview = fermipy.scripts.HEALview:main
fermipy-healview-diffuse-sg = fermipy.diffuse.job_library:invoke_sg_healview_diffuse
fermipy-init-model = fermipy.diffuse.gt_assemble_model:main_init
fermipy-intensity-map = fermipy.scripts.intensity_map:main
fermipy-job-archive = fermipy.jobs.job_archive:main_browse
fermipy-merge-srcmaps = fermipy.diffuse.gt_merge_srcmaps:main_single
fermipy-merge-srcmaps-sg = fermipy.diffuse.gt_merge_srcmaps:main_batch
fermipy-merit-response = fermipy.scripts.merit_response:main
fermipy-merit-skimmer = fermipy.scripts.merit_skimmer:main
fermipy-preprocess = fermipy.scripts.preprocess_data:main
fermipy-quick-analysis = fermipy.scripts.quickanalysis:main
fermipy-residual-cr = fermipy.diffuse.residual_cr:main_single
fermipy-residual-cr-chain = fermipy.diffuse.residual_cr:main_chain
fermipy-residual-cr-sg = fermipy.diffuse.residual_cr:main_batch
fermipy-run-tempo = fermipy.scripts.run_tempo:main
fermipy-select = fermipy.scripts.select_data:main
fermipy-split-and-bin = fermipy.diffuse.gt_split_and_bin:main_single
fermipy-split-and-bin-sg = fermipy.diffuse.gt_split_and_bin:main_batch
fermipy-split-and-mktime = fermipy.diffuse.gt_split_and_mktime:main_single
fermipy-split-and-mktime-sg = fermipy.diffuse.gt_split_and_mktime:main_batch
fermipy-srcmaps-catalog-sg = fermipy.diffuse.job_library:invoke_sg_gtsrcmaps_catalog
fermipy-srcmaps-diffuse = fermipy.diffuse.gt_srcmap_partial:main_single
fermipy-srcmaps-diffuse-sg = fermipy.diffuse.gt_srcmap_partial:main_batch
fermipy-sum-ring-gasmaps-sg = fermipy.diffuse.job_library:invoke_sg_sum_ring_gasmaps
fermipy-sunmoon = fermipy.diffuse.solar:main
fermipy-validate = fermipy.scripts.validate:main
fermipy-vstack = fermipy.scripts.vstack_images:main
fermipy-vstack-diffuse-sg = fermipy.diffuse.job_library:invoke_sg_vstack_diffuse

